################
#1             #
#  ##      ##  #
#  ##      ##  #
#              #
#      ##      #
#      ##      #
#              #
#  ##      ##  #
#  ##      ##  #
#             2#
################
