##########
#1       #
#        #
#   ##   #
#   ##   #
#        #
#        #
#       2#
##########
