Simple Test Battle
MaxSteps = 100
NumShells = 16
Rows = 10
Cols = 15
###############
#      @      #
#  1       2  #
#             #
#     ###     #
#     ###     #
#             #
#  1       2  #
#      @      #
###############
```